M.############.M
#.##M0....2M##.#
..#M.T#..#T.M#..
#..#........#..#
##...#.##.#...##
##....####....##
##...######...##
###..######..###
###..######..###
##...######...##
##....####....##
##...#.##.#...##
#..#........#..#
..#M.T#..#T.M#..
#.##M1....3M##.#
M.############.M