####TT####
#........#
M0..##..2M
##..MM..##
##M....M##
##M....M##
##..MM..##
M1..##..3M
#........#
####TT####