..######..
#..####..#
..0.MM.2..
#.T.##.T.#
..........
..........
#.T.##.T.#
..1.MM.3..
#..####..#
..######..