#..###..###..#
....#....#....
..0........2..
.M.#.#TT#.#.M.
.############.
.##..####..##.
......##......
......##......
.##..####..##.
.############.
.M.#.#TT#.#.M.
..1........3..
....#....#....
#..###..###..#